####################
#..................#
#.....###.......####
#.....###..........#
#..................#
#####)###]##########
#......#...........#
##....##...#...#...#
#......#...........#
##....##...#...#...#
#......#...........#
##....#####)###)####
#......)...........#
####################
