14 7
##############
#....#.......#
#....#.......#
#....#.......#
#....].......#
#....#.......#
##############
